'P'ause = commands/moan_p.htm
'A'nimate = commands/moan_a.htm
Set Channel Program = commands/setchannelprogram.htm
Raw Key Modifier Command = commands/rawkeymodifier.htm
Remove Viewport From Channel = commands/removeviewportfromchannel.htm
'S'cale = commands/moan_s.htm
Sprite Rotating = commands/spriterotating.htm
Restore = commands/restore.htm
Add Sprite To Channel = commands/addspritetochannel.htm
Raw Key Modifier Option = commands/rawkeymodifier.htm
Set Channel Register = commands/channelregister.htm
Bit Shift = commands/bitshift.htm
Resume Channel = commands/resumechannel.htm
Raw Key Modifier Caps Lock = commands/rawkeymodifier.htm
'M'ove = commands/moan_m.htm
Set String Editor Contents = commands/setstringeditorcontents.htm
Bit Set = commands/bitset.htm
Clear Keyboard = commands/clearkeyboard.htm
Sprite Moving = commands/spritemoving.htm
'J'ump = commands/moan_j.htm
Rotate Sprite = commands/rotatesprite.htm
Move Viewport = commands/moveviewport.htm
Step Moan = commands/stepmoan.htm
'L'et = commands/moan_l.htm
Raw Key Filter Number = commands/rawkeyfilter.htm
'I'f = commands/moan_i.htm
Ascii to Char = commands/asciitochar.htm
Text Descent = commands/textdescent.htm
Move Sprite = commands/movesprite.htm
FX Matrix = commands/fxmatrix.htm
Mid Str = commands/midstr.htm
Char to Ascii = commands/chartoascii.htm
Ascii Codes Explained = guides/asciicodesexplained.htm
Right Str = commands/rightstr.htm
Raw Key Ascii = commands/rawkeyascii.htm
Animate Sprite = commands/animatesprite.htm
Graphics Mode = commands/graphicsmode.htm
Raw Key Modifier Shift = commands/rawkeymodifier.htm
Raw Key filter Navigation = commands/rawkeyfilter.htm
Viewport Moving = commands/viewportmoving.htm
Channel Moving = commands/channelmoving.htm
String Editor Cursor = commands/stringeditorcursor.htm
Keyboard Raw Key = commands/keyboardrawkey.htm
Regs (X,Y,I,R0-R9,RA-RZ) = commands/moan_regs.htm
Sprite Animating = commands/spriteanimating.htm
Sprite Exists = commands/spriteexists.htm
Add Viewport To Channel = commands/addviewporttochannel.htm
Raw Key Filter = commands/rawkeyfilter.htm
Read = commands/read.htm
Raw Key Filter Delete = commands/rawkeyfilter.htm
Bit Test = commands/bittest.htm
Channel Paused = commands/channelpaused.htm
Scale Sprite = commands/scalesprite.htm
Raw Key Scancode = commands/rawkeyscancode.htm
Wait Key Press = commands/waitkeypress.htm
Window Mode = commands/graphicsmode.htm
Channel Running = commands/channelrunning.htm
'F'or = commands/moan_f.htm
Raw Key Modifier = commands/rawkeymodifier.htm
String Editor Input = commands/stringeditorinput.htm
Introduction to Keyboard Reading = guides/keyboard_guide.htm
Pause Channel = commands/pausechannel.htm
Text Height = commands/textheight.htm
Window Mode Hardware = commands/graphicsmode.htm
Remove Sprite From Channel = commands/removespritefromchannel.htm
Channel Register = commands/channelregister.htm
Sprite Scaling = commands/spritescaling.htm
Left Str = commands/leftstr.htm
Raw Key Filter Printable = commands/rawkeyfilter.htm
Text Width = commands/textwidth.htm
String Editor Contents = commands/stringeditorcontents.htm
String Editor = guides/keyboard_guide.htm#stringeditor
Raw Key Char = commands/rawkeychar.htm
Auto Moan = commands/automoan.htm
Reset Channel = commands/resetchannel.htm
Keyboard Input Guide = guides/keyboard_guide.htm
Graphics Mode Hardware = commands/graphicsmode.htm
Set String Editor Cursor = commands/setstringeditorcursor.htm
'R'otate = commands/moan_r.htm
Unload Sounds = commands/unloadsounds.htm
Raw Key Modifier Control = commands/rawkeymodifier.htm
Restart Channel = commands/restartchannel.htm
Channel Animating = commands/channelanimating.htm
Keyboard Repeat = commands/keyboardrepeat.htm
Data = commands/data.htm
